1111111111111
10000C00C0001
1000000000P01
1000000E00001
1111111111111