1111111111111
100C000000001
1000000P00001
1000000000E01
1111111111111