111111111111111111111
10000C00C0000100000C1
1000000000P0C10C00011
1000000E0000000000C01
100000000101000000011
111111111111111111111