111111111111111111111
1000000000001C1000001
10000000CEP0101000001
100000000000000000001
111111111111111111111