111111111111111111111
1000000000001C1000001
10000000C0P0101000001
1000000N0000000000001
1000000000001C1000001
10000000C000101000001
1000000N0000000000001
1000000000001C1000001
10000000CE00101000001
1000000N0000000000001
111111111111111111111