111111111111111111111
1000000N0000010000001
10000000000C010000011
100C000000E000P000001
100000000101000000011
111111111111111111111