111111111111111111111
1000000N0000010000001
100000000N0C010000011
100C0000000000P000001
1CE000000101000000011
111111111111111111111